11111111111111111111111111111111
1      2          2      1     1
1      2          2      1     1
1      2          2      1     1
1222         1    2      1     1
1            1                 1
1            1                 1
11111111     1          11111111
1           11111111           1
1           1      1           1
1           1      1           1
1           2      2           1
122222      2      2      222221
1           1      1           1
1           1      1           1
1           11111111           1
11111111          1     11111111
1                 1            1
1                 1            1
1      1     2    1         2221
1      1     2          2      1
1      1     2          2      1
1      1     2          2      1
11111111111111111111111111111111